###############
#P..A....B...E#
#..##..B..C...#
#..##......C..#
#....A....B...#
###############
