###############
#P..A.A.A..E..#
#.###+###+###.#
#...A...A...A.#
#.A.A.A.A.A.A.#
#...A...A...A.#
#.###+###+###.#
#...B...B...B.#
#.B.B.B.B.B.B.#
#.............#
###############
