###############
#P.......B...E#
#..##..B..C...#
#..##......C..#
#.........B...#
###############
