#############################
#P..#..C...#.......#...E....#
#.#.######.#.#####.#.#####..#
#.#.#....#.#.#...#.#.....#..#
#.#.#.##.#.#.#.#.#.#####.#..#
#.#.#.#..#.#.#.#.#.....#.#..#
#.#.#.#.##.#.#.#.#####.#.#..#
#T..#.#....#.#.#.....#.#.#..#
###.#.######.#.#####.#.#.#..#
#............#..C..#.#.#.#..#
#.#########.########........#
#.#.....C..#...C.....#####..#
#.#.#######.#####.#####.#...#
#.......C..#................#
#############################
