#############################
#P....#.....#....#....#.....#
#.###.#.###.#.##.#.###.###..#
#.#...#.#...#.#..#.#...#...E#
#.#.###.#.###.#.###.#.###.#.#
#.#.#...#...#.#...#.#...#.#.#
#.#.#.#####.#.###.#.####.#..#
#.#.#.....#.#...#.#.....#...#
#.#.#####.#.###.#.#####.##..#
#.#.....#.#.#.#.#.....#..C..#
#.#####.#.#.#.#.#.#####.##..#
#.#...#.#.#...#.#.#...#.....#
#.#.#.#.#.###.#.#.#.#.#.#####
#.#...#...C.#...#...#....C..#
#T###########################
#############################
