#############################
#P.....C..##.....####.......#
#.###.######.###...######...#
#.#...#...##....##....#EC...#
#.#.###.#.#.###.#.###.##....#
#.#.#...#.#.......#...#.....#
#.#.#.###.#.#.###.#.###..#..#
#.#.#...#.#.#...#.#...#..#..#
#.#.###.#.#.###.#.###.#..#..#
#.#.....#.#.....#.....#..#..#
#.#######...######.####..#..#
#.#...C..........#....#..#..#
#.#########.#########.#..#..#
#.#########..C...####.......#
#############################
