#############################
#P....#..C.....#............#
#.###.######.###.#.####..#..#
#.#...#...#...........#..#..#
#.#.###.#.#.###.#.###.#..#..#
#.#.#...#.#.#...#.#...#..#..#
#.#.#.###.#.#.###.#.###..#..#
#.#.#...#.#.#...#.#...#..#..#
#.#.###.#.#.###.#.###.#..#..#
#.#.....#.#...........#..#..#
#.#######.########.####..#..#
#.#...C.........##...##..#..#
#.#######.#####.####.#####..#
#T#...C...#####......#F.....#
#############################
